F 0,76,255   
C 9,99,99  

NO 				/texte

SO textures/simonkraft/cobblestone_01.xpm     
WE textures/simonkraft/mossy_cobblestone1.xpm
EA textures/simonkraft/mossy_cobblestone1.xpm

1111111111111111111
1000001001001000001
1000000001000001001 111111111111111111111111111111111111111111111111111111111111111111111111
1000W01001111101111 1111111111100000000001
100111100000100100011    1111111111111111
1000000000000001000001
100111111111100100111
11110000000000010111111
100000001111101000000001
11111111111111111111111


